111111111
111111112
111111113
111111114
111111115